$$$ exec p1 : [resources/players/jallen.filler]
Plateau 15 17:
    01234567890123456
000 .................
001 .................
002 .................
003 .................
004 .................
005 .................
006 .................
007 ...OO............
008 ..OOO............
009 .................
010 .............111.
011 ............11x1.
012 ............1xx1.
013 ............1111.
014 .................
Piece 1 2:
**
