$$$ exec p2 : [resources/players/jallen.filler]
Plateau 15 17:
    01234567890123456
000 .................
001 .................
002 .................
003 .................
004 .................
005 .................
006 .................
007 ...OO............
008 ..OOO............
009 .................
010 .................
011 ..............x..
012 .............xx..
013 .................
014 .................
Piece 1 2:
**
